# MVP Ship Cabin Interior
# Legend:
# W = Wall/Bulkhead
# F = Floor
# D = Door/Hatch
# H = Helm/Navigation
# C = Chair/Seat
# B = Bed/Quarters
# T = Table
# S = Storage/Cargo
# M = Machinery/Engine access
# E = Exit (to dock or EVA)
# @ = Player starting position

WWWWWWWWWWWWWWWW
WFFFFFFFWBBBBBBW
WFFFHFFFWFFFFFFW
WFFFCFFFDFFFFTTW
WFFFFFFFDFFFFCCW
WFFFFFFFWFFFFFFW
WFFFFFFFWSSSSSSW
WFFFFFFFWSSSSSSW
WFFF@FFFWMMMMMMW
WFFFFFFFWMMMMMMW
WFFFFFFFDFFFFFFW
WDDWWWWWWWWWWWWW
WFFFFFFFDFFFFFEW
WFFFFFFFDFFFFFEW
WFFFFFFFWFFFFFFW
WMMMMMMMWMMMMMMW
WWWWWWWWWWWWWWWW